"filename", "language", "Python", "JSON", "comment", "blank", "total"
"c:\Users\14404\Project\rtsr_client\src\CiliCili\FlowLayout.py", "Python", 130, 0, 18, 29, 177
"c:\Users\14404\Project\rtsr_client\src\CiliCili\MainWindow.py", "Python", 286, 0, 27, 54, 367
"c:\Users\14404\Project\rtsr_client\src\CiliCili\UItils\VideoCardParser.py", "Python", 3, 0, 0, 4, 7
"c:\Users\14404\Project\rtsr_client\src\CiliCili\VideoCard\VideoCard.py", "Python", 59, 0, 37, 17, 113
"c:\Users\14404\Project\rtsr_client\src\CiliCili\VideoCard\VideoCardParser.py", "Python", 86, 0, 55, 17, 158
"c:\Users\14404\Project\rtsr_client\src\CiliCili\VideoInfo\EpisodeInfo.py", "Python", 107, 0, 28, 20, 155
"c:\Users\14404\Project\rtsr_client\src\CiliCili\VideoInfo\VideoInfo.py", "Python", 109, 0, 28, 19, 156
"c:\Users\14404\Project\rtsr_client\src\CiliCili\ui\MainWindow_UI.py", "Python", 498, 0, 7, 8, 513
"c:\Users\14404\Project\rtsr_client\src\CiliCili\ui\VideoCard_UI.py", "Python", 109, 0, 8, 8, 125
"c:\Users\14404\Project\rtsr_client\src\CiliCili\ui\assets.py", "Python", 636, 0, 6, 11, 653
"c:\Users\14404\Project\rtsr_client\src\OfflineSuperResolution\OfflineSuperResolutionWindow.py", "Python", 164, 0, 10, 28, 202
"c:\Users\14404\Project\rtsr_client\src\OfflineSuperResolution\Ui\Ui_OfflineSuperResolutionWindow.py", "Python", 184, 0, 7, 8, 199
"c:\Users\14404\Project\rtsr_client\src\OfflineSuperResolution\Worker\VideoEncodeWorker.py", "Python", 118, 0, 9, 20, 147
"c:\Users\14404\Project\rtsr_client\src\OfflineSuperResolution\run.py", "Python", 36, 0, 3, 9, 48
"c:\Users\14404\Project\rtsr_client\src\Player\BasePlayer.py", "Python", 83, 0, 24, 28, 135
"c:\Users\14404\Project\rtsr_client\src\Player\CiliCiliPlayer.py", "Python", 100, 0, 30, 31, 161
"c:\Users\14404\Project\rtsr_client\src\Player\Context\AudioContext.py", "Python", 67, 0, 2, 5, 74
"c:\Users\14404\Project\rtsr_client\src\Player\Context\VideoContext.py", "Python", 85, 0, 1, 13, 99
"c:\Users\14404\Project\rtsr_client\src\Player\Device\AudioDevice.py", "Python", 14, 0, 21, 12, 47
"c:\Users\14404\Project\rtsr_client\src\Player\Device\DisplayDevice.py", "Python", 192, 0, 79, 34, 305
"c:\Users\14404\Project\rtsr_client\src\Player\Device\DisplayDevice_bak.py", "Python", 271, 0, 208, 84, 563
"c:\Users\14404\Project\rtsr_client\src\Player\Layer\CustomLayer.py", "Python", 0, 0, 0, 1, 1
"c:\Users\14404\Project\rtsr_client\src\Player\Layer\DisplayLayer.py", "Python", 56, 0, 18, 16, 90
"c:\Users\14404\Project\rtsr_client\src\Player\Layer\InfoLayer.py", "Python", 0, 0, 0, 1, 1
"c:\Users\14404\Project\rtsr_client\src\Player\Layer\PlayerControlLayer.py", "Python", 128, 0, 14, 38, 180
"c:\Users\14404\Project\rtsr_client\src\Player\PlayerWindow.py", "Python", 260, 0, 33, 52, 345
"c:\Users\14404\Project\rtsr_client\src\Player\Ui\CiliCiliPlayerContainer.py", "Python", 19, 0, 7, 7, 33
"c:\Users\14404\Project\rtsr_client\src\Player\Ui\PlayerAssets.py", "Python", 703, 0, 6, 11, 720
"c:\Users\14404\Project\rtsr_client\src\Player\Ui\PlayerWindow_UI.py", "Python", 514, 0, 7, 7, 528
"c:\Users\14404\Project\rtsr_client\src\Player\Ui\SeekSlider.py", "Python", 82, 0, 12, 11, 105
"c:\Users\14404\Project\rtsr_client\src\Player\Ui\Ui_PlayerControlLayer.py", "Python", 334, 0, 7, 8, 349
"c:\Users\14404\Project\rtsr_client\src\Player\Ui\playControlBar.py", "Python", 338, 0, 7, 11, 356
"c:\Users\14404\Project\rtsr_client\src\Player\Utils\BinaryNeuron.py", "Python", 36, 0, 0, 8, 44
"c:\Users\14404\Project\rtsr_client\src\Player\Utils\CudaAutoInit.py", "Python", 9, 0, 0, 3, 12
"c:\Users\14404\Project\rtsr_client\src\Player\Utils\DecoderExceptionCheckThread.py", "Python", 24, 0, 2, 3, 29
"c:\Users\14404\Project\rtsr_client\src\Player\Utils\Delay.py", "Python", 25, 0, 9, 9, 43
"c:\Users\14404\Project\rtsr_client\src\Player\Utils\HHMMSS2ms.py", "Python", 9, 0, 0, 2, 11
"c:\Users\14404\Project\rtsr_client\src\Player\Utils\MediaInfo.py", "Python", 16, 0, 0, 5, 21
"c:\Users\14404\Project\rtsr_client\src\Player\Utils\MediaSource.py", "Python", 63, 0, 10, 18, 91
"c:\Users\14404\Project\rtsr_client\src\Player\Utils\PlayClock.py", "Python", 17, 0, 0, 3, 20
"c:\Users\14404\Project\rtsr_client\src\Player\Utils\PlayStatusController.py", "Python", 63, 0, 12, 11, 86
"c:\Users\14404\Project\rtsr_client\src\Player\Worker\AudioDecodeWorker.py", "Python", 189, 0, 26, 29, 244
"c:\Users\14404\Project\rtsr_client\src\Player\Worker\AudioPlayWorker.py", "Python", 97, 0, 12, 25, 134
"c:\Users\14404\Project\rtsr_client\src\Player\Worker\PlayWorker.py", "Python", 397, 0, 70, 81, 548
"c:\Users\14404\Project\rtsr_client\src\Player\Worker\RTSRWorker.py", "Python", 44, 0, 0, 12, 56
"c:\Users\14404\Project\rtsr_client\src\Player\Worker\VideoDecodeWorker.py", "Python", 88, 0, 9, 16, 113
"c:\Users\14404\Project\rtsr_client\src\Player\Worker\VideoPlayWorker.py", "Python", 177, 0, 26, 36, 239
"c:\Users\14404\Project\rtsr_client\src\SuperResolutionInferencer\FSRCNN\FSRCNN.py", "Python", 35, 0, 12, 12, 59
"c:\Users\14404\Project\rtsr_client\src\SuperResolutionInferencer\FSRCNN\Model\FSRCNNModel.py", "Python", 33, 0, 0, 5, 38
"c:\Users\14404\Project\rtsr_client\src\SuperResolutionInferencer\IMDN-AVC\IMDN.py", "Python", 40, 0, 14, 11, 65
"c:\Users\14404\Project\rtsr_client\src\SuperResolutionInferencer\IMDN-AVC\Model\architecture.py", "Python", 110, 0, 4, 39, 153
"c:\Users\14404\Project\rtsr_client\src\SuperResolutionInferencer\IMDN-AVC\Model\block.py", "Python", 173, 0, 1, 34, 208
"c:\Users\14404\Project\rtsr_client\src\SuperResolutionInferencer\IMDN-REDS\IMDN.py", "Python", 40, 0, 14, 11, 65
"c:\Users\14404\Project\rtsr_client\src\SuperResolutionInferencer\IMDN-REDS\Model\architecture.py", "Python", 110, 0, 4, 39, 153
"c:\Users\14404\Project\rtsr_client\src\SuperResolutionInferencer\IMDN-REDS\Model\block.py", "Python", 173, 0, 1, 34, 208
"c:\Users\14404\Project\rtsr_client\src\SuperResolutionInferencer\SuperResolutionInferencerRegister.json", "JSON", 0, 15, 0, 0, 15
"c:\Users\14404\Project\rtsr_client\src\VideoProcessor\HandlerCmd.py", "Python", 11, 0, 0, 6, 17
"c:\Users\14404\Project\rtsr_client\src\VideoProcessor\Inferencer.py", "Python", 5, 0, 8, 3, 16
"c:\Users\14404\Project\rtsr_client\src\VideoProcessor\SRContext.py", "Python", 11, 0, 0, 4, 15
"c:\Users\14404\Project\rtsr_client\src\VideoProcessor\SRStatusCode.py", "Python", 15, 0, 0, 5, 20
"c:\Users\14404\Project\rtsr_client\src\VideoProcessor\SRWorker.py", "Python", 36, 0, 3, 7, 46
"c:\Users\14404\Project\rtsr_client\src\VideoProcessor\Utils\ClassLoader.py", "Python", 4, 0, 1, 1, 6
"c:\Users\14404\Project\rtsr_client\src\VideoProcessor\VideoDecoder.py", "Python", 187, 0, 21, 22, 230
"c:\Users\14404\Project\rtsr_client\src\VideoProcessor\VideoProcessorHandler.py", "Python", 105, 0, 30, 29, 164
"c:\Users\14404\Project\rtsr_client\src\main.py", "Python", 105, 0, 25, 38, 168
"c:\Users\14404\Project\rtsr_client\src\runOSR.py", "Python", 5, 0, 0, 1, 6
"Total", "-", 8223, 15, 1033, 1184, 10455